+------+
| 1    |
| 1  5 |
|002 5 
|  2   |
|3  444|
|3     |
+------+