+------+
|11 2  |
|   2  |
|**   3
| 6   3|
| 6 443|
|   555|
+------+