+------+
|  2  0|
|  21 0|
|** 13 
|    3 |
|55543 |
|   4  |
+------+