+------+
|0 6678|
|055578|
|**234 
|11234 |
|   9aa|
|   9bb|
+------+