+------+
|   b  |
|  1b22|
|**1345
|66 345|
|a7779 |
|a8889 |
+------+