+------+
|000456|
|22 456|
|3**457
|3 88 7|
|  9aaa|
|  9bbb|
+------+