+------+
|1222 4|
|1333 4|
|**   4
| 556  |
|  7699|
|8876  |
+------+